.###@#.#.#
...#......
.#.#####.#
##........
#.........
#.........
.....#####
.....#....
..........
##...#####