##################
#+..............@#
#.#.#........#.#.#
#.#.#..####..#.#.#
#.#.#........#.#.#
#......####.....+#
#.#.#........#.#.#
#.#.#..####..#.#.#
#.#.#...+....#.#.#
#+.....####......#
#.#.#........#.#.#
#.#.#..####..#.#.#
#.#.#........#.#.#
#...+.......+....#
##################