##########
#.......@#
#.##.###.#
#.#....#.#
#...##.#.#
#.#.##...#
#.#....#.#
#.###.##.#
#........#
##########