##################
#................#
#.##############.#
#.#............#.#
#.#.####.#####.#.#
#.#.#........#.#.#
#+#.#.######.#.#.#
#...#.....@#...#.#
#.#.#.######.#.#.#
#.#.#...+....#.#.#
#.#.##########.#.#
#.#..........+.#.#
#.######.#######.#
#...+............#
##################