##################
#+......+.......+#
#..#..#..#..#..#.#
#.....#..#..#....#
#..#..#..#..#..#.#
#..+..#..#..#..+.#
#..#..#..#..#..#.#
#................#
#..#..#..#..#..#.#
#.+...#..#..#..+.#
#..#..#..#..#..#.#
#.....#..#..#....#
#..#..#..#..#..#.#
#+......@.......+#
##################